;  1

##############
#ee@ee f  $ .#
##############
