;  2

##############
#  @ ##  $  .#
#    e f  f  #
##############
