;  2

##############
# e  @#  f$ .#
# e#ff    ####
####e#  $   .#
##############
