;  2

##############
#e  @      f##
#.#### # $f  #
# f$ # ###  $#
#    e  e# ..#
##############
