;  2

##############
#e  @    f  ##
#  f e  e# ..#
# f$f# ###  $#
#  f      f  #
#.#### # $f  #
# f$ # ###  $#
# f  e  e# ..#
##############
