; 3 'original level #1 revised'

    #####       ####      
    #   ####    #  ##     
    #      #    #   ######
    ## $$  #    #        #
   ####  $##    ## .... .#
   #   $$ ##     ##  #. .#
#### ## #  #      #  #.  #
#   $## ## ############ ##
# #    $      @         # 
#   #####  ###########$ # 
#####   ####         #  # 
                     #### 
